Andorra	UN member	AD	AND
United Arab Emirates (the)	UN member	AE	ARE
Afghanistan	UN member	AF	AFG
Antigua and Barbuda	UN member	AG	ATG
Anguilla	United Kingdom	AI	AIA
Albania	UN member	AL	ALB
Armenia	UN member	AM	ARM
Angola	UN member	AO	AGO
Antarctica [b]	Antarctic Treaty	AQ	ATA
Argentina	UN member	AR	ARG
American Samoa	United States	AS	ASM
Austria	UN member	AT	AUT
Australia [c]	UN member	AU	AUS
Aruba	Netherlands	AW	ABW
Åland Islands	Finland	AX	ALA
Azerbaijan	UN member	AZ	AZE
Bosnia and Herzegovina	UN member	BA	BIH
Barbados	UN member	BB	BRB
Bangladesh	UN member	BD	BGD
Belgium	UN member	BE	BEL
Burkina Faso	UN member	BF	BFA
Bulgaria	UN member	BG	BGR
Bahrain	UN member	BH	BHR
Burundi	UN member	BI	BDI
Benin	UN member	BJ	BEN
Saint Barthélemy	France	BL	BLM
Bermuda	United Kingdom	BM	BMU
Brunei Darussalam [f]	UN member	BN	BRN
Bolivia (Plurinational State of)	UN member	BO	BOL
"Bonaire
 Sint Eustatius
 Saba"	Netherlands	BQ	BES
Brazil	UN member	BR	BRA
Bahamas (the)	UN member	BS	BHS
Bhutan	UN member	BT	BTN
Bouvet Island	Norway	BV	BVT
Botswana	UN member	BW	BWA
Belarus	UN member	BY	BLR
Belize	UN member	BZ	BLZ
Canada	UN member	CA	CAN
Cocos (Keeling) Islands (the)	Australia	CC	CCK
Congo (the Democratic Republic of the)	UN member	CD	COD
Central African Republic (the)	UN member	CF	CAF
Congo (the) [h]	UN member	CG	COG
Switzerland	UN member	CH	CHE
Côte d'Ivoire [i]	UN member	CI	CIV
Cook Islands (the)	New Zealand	CK	COK
Chile	UN member	CL	CHL
Cameroon	UN member	CM	CMR
China	UN member	CN	CHN
Colombia	UN member	CO	COL
Costa Rica	UN member	CR	CRI
Cuba	UN member	CU	CUB
Cabo Verde [g]	UN member	CV	CPV
Curaçao	Netherlands	CW	CUW
Christmas Island	Australia	CX	CXR
Cyprus	UN member	CY	CYP
Czechia [j]	UN member	CZ	CZE
Germany	UN member	DE	DEU
Djibouti	UN member	DJ	DJI
Denmark	UN member	DK	DNK
Dominica	UN member	DM	DMA
Dominican Republic (the)	UN member	DO	DOM
Algeria	UN member	DZ	DZA
Ecuador	UN member	EC	ECU
Estonia	UN member	EE	EST
Egypt	UN member	EG	EGY
Western Sahara [aj]	Disputed [ak]	EH	ESH
Eritrea	UN member	ER	ERI
Spain	UN member	ES	ESP
Ethiopia	UN member	ET	ETH
Finland	UN member	FI	FIN
Fiji	UN member	FJ	FJI
Falkland Islands (the) [Malvinas] [l]	United Kingdom	FK	FLK
Micronesia (Federated States of)	UN member	FM	FSM
Faroe Islands (the)	Denmark	FO	FRO
France [m]	UN member	FR	FRA
Gabon	UN member	GA	GAB
United Kingdom of Great Britain and Northern Ireland (the)	UN member	GB	GBR
Grenada	UN member	GD	GRD
Georgia	UN member	GE	GEO
French Guiana	France	GF	GUF
Guernsey	British Crown	GG	GGY
Ghana	UN member	GH	GHA
Gibraltar	United Kingdom	GI	GIB
Greenland	Denmark	GL	GRL
Gambia (the)	UN member	GM	GMB
Guinea	UN member	GN	GIN
Guadeloupe	France	GP	GLP
Equatorial Guinea	UN member	GQ	GNQ
Greece	UN member	GR	GRC
South Georgia and the South Sandwich Islands	United Kingdom	GS	SGS
Guatemala	UN member	GT	GTM
Guam	United States	GU	GUM
Guinea-Bissau	UN member	GW	GNB
Guyana	UN member	GY	GUY
Hong Kong	China	HK	HKG
Heard Island and McDonald Islands	Australia	HM	HMD
Honduras	UN member	HN	HND
Croatia	UN member	HR	HRV
Haiti	UN member	HT	HTI
Hungary	UN member	HU	HUN
Indonesia	UN member	ID	IDN
Ireland	UN member	IE	IRL
Israel	UN member	IL	ISR
Isle of Man	British Crown	IM	IMN
India	UN member	IN	IND
British Indian Ocean Territory (the)	United Kingdom	IO	IOT
Iraq	UN member	IQ	IRQ
Iran (Islamic Republic of)	UN member	IR	IRN
Iceland	UN member	IS	ISL
Italy	UN member	IT	ITA
Jersey	British Crown	JE	JEY
Jamaica	UN member	JM	JAM
Jordan	UN member	JO	JOR
Japan	UN member	JP	JPN
Kenya	UN member	KE	KEN
Kyrgyzstan	UN member	KG	KGZ
Cambodia	UN member	KH	KHM
Kiribati	UN member	KI	KIR
Comoros (the)	UN member	KM	COM
Saint Kitts and Nevis	UN member	KN	KNA
Korea (the Democratic People's Republic of) [p]	UN member	KP	PRK
Korea (the Republic of) [q]	UN member	KR	KOR
Kuwait	UN member	KW	KWT
Cayman Islands (the)	United Kingdom	KY	CYM
Kazakhstan	UN member	KZ	KAZ
Lao People's Democratic Republic (the) [r]	UN member	LA	LAO
Lebanon	UN member	LB	LBN
Saint Lucia	UN member	LC	LCA
Liechtenstein	UN member	LI	LIE
Sri Lanka	UN member	LK	LKA
Liberia	UN member	LR	LBR
Lesotho	UN member	LS	LSO
Lithuania	UN member	LT	LTU
Luxembourg	UN member	LU	LUX
Latvia	UN member	LV	LVA
Libya	UN member	LY	LBY
Morocco	UN member	MA	MAR
Monaco	UN member	MC	MCO
Moldova (the Republic of)	UN member	MD	MDA
Montenegro	UN member	ME	MNE
Saint Martin (French part)	France	MF	MAF
Madagascar	UN member	MG	MDG
Marshall Islands (the)	UN member	MH	MHL
North Macedonia [u]	UN member	MK	MKD
Mali	UN member	ML	MLI
Myanmar [t]	UN member	MM	MMR
Mongolia	UN member	MN	MNG
Macao [s]	China	MO	MAC
Northern Mariana Islands (the)	United States	MP	MNP
Martinique	France	MQ	MTQ
Mauritania	UN member	MR	MRT
Montserrat	United Kingdom	MS	MSR
Malta	UN member	MT	MLT
Mauritius	UN member	MU	MUS
Maldives	UN member	MV	MDV
Malawi	UN member	MW	MWI
Mexico	UN member	MX	MEX
Malaysia	UN member	MY	MYS
Mozambique	UN member	MZ	MOZ
Namibia	UN member	NA	NAM
New Caledonia	France	NC	NCL
Niger (the)	UN member	NE	NER
Norfolk Island	Australia	NF	NFK
Nigeria	UN member	NG	NGA
Nicaragua	UN member	NI	NIC
Netherlands, Kingdom of the	UN member	NL	NLD
Norway	UN member	NO	NOR
Nepal	UN member	NP	NPL
Nauru	UN member	NR	NRU
Niue	New Zealand	NU	NIU
New Zealand	UN member	NZ	NZL
Oman	UN member	OM	OMN
Panama	UN member	PA	PAN
Peru	UN member	PE	PER
French Polynesia	France	PF	PYF
Papua New Guinea	UN member	PG	PNG
Philippines (the)	UN member	PH	PHL
Pakistan	UN member	PK	PAK
Poland	UN member	PL	POL
Saint Pierre and Miquelon	France	PM	SPM
Pitcairn [v]	United Kingdom	PN	PCN
Puerto Rico	United States	PR	PRI
Palestine, State of	UN observer	PS	PSE
Portugal	UN member	PT	PRT
Palau	UN member	PW	PLW
Paraguay	UN member	PY	PRY
Qatar	UN member	QA	QAT
Réunion	France	RE	REU
Romania	UN member	RO	ROU
Serbia	UN member	RS	SRB
Russian Federation (the) [w]	UN member	RU	RUS
Rwanda	UN member	RW	RWA
Saudi Arabia	UN member	SA	SAU
Solomon Islands	UN member	SB	SLB
Seychelles	UN member	SC	SYC
Sudan (the)	UN member	SD	SDN
Sweden	UN member	SE	SWE
Singapore	UN member	SG	SGP
"Saint Helena
 Ascension Island
 Tristan da Cunha"	United Kingdom	SH	SHN
Slovenia	UN member	SI	SVN
"Svalbard
 Jan Mayen"	Norway	SJ	SJM
Slovakia	UN member	SK	SVK
Sierra Leone	UN member	SL	SLE
San Marino	UN member	SM	SMR
Senegal	UN member	SN	SEN
Somalia	UN member	SO	SOM
Suriname	UN member	SR	SUR
South Sudan	UN member	SS	SSD
Sao Tome and Principe	UN member	ST	STP
El Salvador	UN member	SV	SLV
Sint Maarten (Dutch part)	Netherlands	SX	SXM
Syrian Arab Republic (the) [y]	UN member	SY	SYR
Eswatini [k]	UN member	SZ	SWZ
Turks and Caicos Islands (the)	United Kingdom	TC	TCA
Chad	UN member	TD	TCD
French Southern Territories (the) [n]	France	TF	ATF
Togo	UN member	TG	TGO
Thailand	UN member	TH	THA
Tajikistan	UN member	TJ	TJK
Tokelau	New Zealand	TK	TKL
Timor-Leste [ab]	UN member	TL	TLS
Turkmenistan	UN member	TM	TKM
Tunisia	UN member	TN	TUN
Tonga	UN member	TO	TON
Türkiye[ac]	UN member	TR	TUR
Trinidad and Tobago	UN member	TT	TTO
Tuvalu	UN member	TV	TUV
Taiwan (Province of China) [z]	Disputed [aa]	TW	TWN
Tanzania, the United Republic of	UN member	TZ	TZA
Ukraine	UN member	UA	UKR
Uganda	UN member	UG	UGA
United States Minor Outlying Islands (the) [ae]	United States	UM	UMI
United States of America (the)	UN member	US	USA
Uruguay	UN member	UY	URY
Uzbekistan	UN member	UZ	UZB
Holy See (the) [o]	UN observer	VA	VAT
Saint Vincent and the Grenadines	UN member	VC	VCT
Venezuela (Bolivarian Republic of)	UN member	VE	VEN
Virgin Islands (British) [ah]	United Kingdom	VG	VGB
Virgin Islands (U.S.) [ai]	United States	VI	VIR
Viet Nam [ag]	UN member	VN	VNM
Vanuatu	UN member	VU	VUT
Wallis and Futuna	France	WF	WLF
Samoa	UN member	WS	WSM
Yemen	UN member	YE	YEM
Mayotte	France	YT	MYT
South Africa	UN member	ZA	ZAF
Zambia	UN member	ZM	ZMB
Zimbabwe	UN member	ZW	ZWE